WnYWCwVFqyaqjPZ -> Zote
LVCTLwCIZxHdfCX -> XT
XKDDHvjrDtAZaxG -> Grott, Maryland
xRxeycVOeMRrKQB -> Baton, Supreme
fWQxTQJhzPZlIKT -> T's
nwwJgqupnREhigL -> Lette Hard Ham
fNapayygoqYScqU -> Uant
mvVrWdCFehQyKoU -> Ut Egg
HSNePFUqoGSXxJÄ -> Ä
mEcMksAWloYaLeW -> Ws
NUfyBMXNRyqwaJR -> R, S.
SrzRnaApXRrCKcF -> Fest, roman, Lambs, Sauce Didaro, Chops, Plain or with Tomat
WbsFsRiJDUdTwRÜ -> Üst
vrwMJqbCKVjflrE -> Etch, Crumbly sauce
VXGJaQEXPCQoaES -> S en Plain Lobster
QSAqYbWmNgUJaQV -> V Stuffer
rqnNeBRhpDppJGÜ -> Üe
kFAlgITpgQoMbZZ -> Zin
RPdSdcHqaneRHtN -> N. 1889
mtvZfbetLMAzqmQ -> Qaton
hEJsluuctTpaSQB -> Bart, Sauce Figaro, and Cream
YnZLiFUAOpWMaAÄ -> Äe Pie
kZRAlJwlQBLZqCJ -> Js
swcwVEDbelknuFU -> U Pies
RKeBywQLcxbOlxÖ -> Öing Oysters, Marlborough special
spXlxOHQMsNFjvU -> U
dVyTaFfoQrBsiqJ -> J, U8pa Witt or toblet
BPnmXjGApJOFWbZ -> ZII4
AXqzXrVtNhzCDzW -> WEtte, 1820
PGVrLenLZhhvOsK -> K. Wil

hLgEDFqmwyxcabZ -> Zarg
yaUdVjQxcAOjKBZ -> Z&)
tQYsFWTtipqaenN -> Non and Ham to Order
knZPEvGgOQnrQBB -> Bern, S2uufs
gGPgbOZbXRjYJhX -> X
sHUrOiEKCEzZiiÜ -> Ü Steak with Onions
dXRVGSbYRXlbSeÜ -> Üt, winh Mackerel
CDBFAiwcEbWkOpY -> Y
GzMGVRFFebjkEzP -> Per Beer
VUVnTOPHkDSINdV -> VE
NlqsweHngCVhAwH -> H
ZhkFMizhCGqKgPN -> Neo
VOAIRGapBSOezvL -> Lard per glass
sLuTJkknGQWnizÖ -> Ö Pie
AEcBxTHECHwwPHQ -> QPElE
AJQQoKGsbXXKEIP -> P
DCRqLRJMsJTwCeR -> RTA
TVHOnaAvsAyFdNM -> MAs
EXBhmhKlOmkcHCM -> Minz& G. L., 1889
wTOjpiSwgoJWcWG -> Gutter, Schlmsz.
UWKOloJgLBuqUfZ -> Z of Oysters, half shell
btWRoCDTNqnnolQ -> Qet, Breaded, Tomato Sauce
LihfoGYglzbZUfW -> W Brandy
KDBhyjWOoireaZT -> Tische pints
TebqbYjwtSTafNC -> Chicken, Grape of Bacon, tomato sauce
BcPAHCjDRsVXQRX -> X
cgsBbfGxCcQpjdX -> Xing stew with Mushrooms
rDsBONGylbslIEQ -> Qch, Estra en
SWiskWPUeJessGP -> Pb Cranberry Sauce
HLKQkMgPdYuGhAÜ -> Ü, Marlbore chips

pYTlQRigqXHANgI -> I
VhGWQpqJOMQlYEC -> CtE
cxTLHWQfrgBKYRW -> W
DyvpfZJUbGsZwGÄ -> Ät
mdhNnOgVPXlQylL -> Lex
YqrhQzDKKDvtuEN -> N, 1884
EmXYsrXbjGQxrWV -> V, 1881
RfAWkikMWEOIrlÜ -> ÜAn
heLpaEhkswrNzwG -> Gher
jvgvpEkgXCCfKVJ -> J, perres & Cocoa
sLVqNwYRWOXOEMP -> PECE
aBajtfQNXzcOCvW -> Win POTALO
fAobRwxRJnjFCFR -> Ret
NwlGqaKbbinGFcS -> S, Granac, Fry potatoes
bLfVQfMyMYeHnTL -> Lus
dowSrTXnxRaUYSS -> Scon
dAMtzrfBatioVRZ -> Zith Pig
HoQTocGCjpYdSlP -> Pand Rye
DfICFVfjYMuRMfM -> MStEC
DrCYvavLdWknpHK -> K
GoJrwTsNEeqJkeO -> Oce, bottle
zgTZIBCLetQBVnK -> KizCIN
SyIeeElBVKmpZwW -> Wzt
ZnOkmjRFnjABrRQ -> Qut
wIEEeixuELirhQH -> Haw Whiskey
cEeKeRzUetbESXJ -> J
EixlYTpuBiSpPbH -> H.
dPRPYnmsLTWvXdI -> I
idYhsfvkWaMVktY -> Yoroed Shad, Martini
MuQhWCEerrTRGGL -> Len, GUAentE, 1/81

eReKcBkskUWwyPJ -> J
LJNUobUPjluoWFS -> Sh rumb, Clams, rafie
uFAyAltUSVVnvWI -> ITETDoin Pudding
gnMqMQbTMZYagQU -> U
deVQOTOaNTegCmÜ -> Ügow Potatoes, Grate
JwhtOxDoFXcAkUF -> Fraiss
HqwbKVIHOnMdElT -> T, Mug or Toby
BBeSHbDoDYuByuF -> Fes
hSrhOWatqmtxOUB -> Bhraniha crum
qcxLTPAJTNiDreY -> Y
eNnBkQEcDQmnXJZ -> Zested with cream
ktjwuphXkTnBbWO -> Ohap, Grando, Vin Nater
tjHmPHNeMPXDPQC -> Ce, MADT'N EASTER
TnNuXAfkAtHvpTD -> Dy
erWmzAkfhdInIxA -> A.
NblhDCCnQifuPwF -> Far
SwPFDtXEXvwhmGK -> K)
beuiZawxqntiGnÄ -> Ä, Breaded, Tomato Sauce
CbYeLCxmvegzBCB -> Bteas
jsAaJaiuYWSVRZP -> P.
RbYdVoomTtNRWfQ -> Qient
rLpvufRSciaPbHX -> XFnica
LKEYbTUeqeOjgfJ -> Jee
EenXlhstBBOojCD -> De
JUcTtokrfVlcevM -> Mice
VMbPjLNdqcKKbJA -> A'S, EsTraus
PuwLmHZkUAiTGYQ -> Q, WITH CREAM POETTES OR SWEET PONASS
CGLZFNKlzUYDRiA -> A, Omple PON
AFRXUhLWCGHdANT -> T
EVxKCQymGhYZSyG -> G.

StGOJJYrWKGrlzO -> O pfate Wine
cYbnovvpTkbhLkH -> Har, Mashed Potatoes
gbHQbzSJXQSXCIP -> PED CORNERS, STOUT BALS SWULE BREAD, ALMONDOSS
zwWRRbgpgFIJzSD -> D'
oZjNrcQjqtRWBiO -> O.
afiIDCznzVyUydU -> Ullet, 1884
MjzTFyTgshvCebR -> Ra, Sherry (Cobrer
yTRKCrJVnnNXYfU -> UsT(,
BmeoFqnVnxmUjPY -> Y SALG
PtSCTUTvlePowfQ -> Qhan
ltACPKnPiaXwkiU -> Us
kpfafhBDGYFtgQG -> Gin
BAhvQphvYNFvHmO -> Otel
aEFbxSRSsMKLaOT -> Tles
myBNefOSydzowbQ -> Qyt
uREisTNGsOSMwQO -> O, Hom Potato, Sauce
YfupDhJeLBOGQAH -> Honta, cepes
hbdiQsGarmUmLgC -> Cand Graven, 1884
YJlLgCxKeqLDQQB -> Bn
zXYwVgjHvlRsNIO -> O
hLrGQvgNAAJjfOU -> UST
wFtwvHNYYYkuwyW -> Whead, Crumb Fry
uwkpwGWBEqVQiJÖ -> Öe
jqpLvOhnVsLFqBN -> N.
mvKVmTptjBHpEUG -> Ge
mPGlkYXKMvDLyGA -> A
JHFGQpxIrHEJBPI -> INE
PIyHSZpAjmwRhND -> DI
tDXXRMKXFddYSFF -> Fe
BmZcuFfgpMctzmR -> R.